####################
#p.................#
#..................#
#..................#
#..................#
#..................#
#..................#
#..................#
#..................#
####################