####################
#p................z#
#..................#
#................e.#
####################