####################
#p................e#
#..................#
#.................e#
#..................#
#.................e#
#..................#
#.................z#
#.................z#
####################